04 04 04 04 04 03 04 04 04 04 03 04 02 02 02 02 02 02 02 02 02 02 02 02 02 02 02 02 02 02 02 02 04 04 04 04 04 04 04 04 04 04 04 04 04 04 04 04 04 04
04 01 04 04 04 04 04 04 04 04 04 02 02 02 02 02 02 02 02 02 02 02 02 02 02 02 02 02 02 02 02 02 00 00 00 00 00 00 00 00 00 00 04 00 00 00 04 04 04 04
04 01 04 04 04 04 04 04 04 04 02 02 02 02 02 02 02 02 02 02 02 02 02 02 02 02 02 02 02 02 02 02 02 00 00 12 10 10 10 10 10 07 04 04 04 04 04 04 04 04 
04 01 01 01 01 01 04 04 04 04 02 02 02 02 02 01 01 01 01 01 01 01 01 01 01 02 02 02 02 02 00 00 00 00 00 13 10 10 10 10 10 13 04 04 04 04 04 04 04 04
03 04 04 04 04 01 00 04 00 02 02 02 03 02 02 01 02 02 02 02 02 02 02 01 01 02 02 02 02 02 00 00 00 00 00 13 10 10 10 10 10 13 04 04 00 00 00 04 04 04
04 04 04 04 04 01 00 00 01 01 01 01 01 01 01 01 02 02 02 02 02 02 02 01 01 02 02 02 02 02 01 01 01 01 00 13 10 10 10 10 10 13 01 01 01 01 01 01 04 04
04 04 04 04 04 01 01 01 17 02 02 02 02 03 05 01 02 02 02 02 02 01 01 01 01 02 02 02 02 02 00 00 04 01 01 13 10 10 10 10 10 13 01 04 00 04 04 04 04 04
04 03 04 04 04 01 04 04 01 04 04 00 02 02 02 01 02 02 02 02 02 01 02 02 01 02 02 02 02 02 02 02 02 01 01 13 10 10 10 10 10 13 01 04 04 04 04 04 04 04
04 04 04 04 03 01 04 04 01 03 03 00 03 02 03 01 02 02 02 02 02 01 02 02 01 02 02 02 02 02 02 02 02 00 01 11 19 19 19 19 19 18 01 00 00 04 04 00 04 04
04 04 04 04 01 01 01 01 01 01 01 00 02 02 03 01 02 02 02 02 02 01 02 02 01 02 02 02 02 02 02 02 02 00 01 15 06 14 14 14 06 15 01 00 04 04 04 04 04 04
04 04 00 04 01 04 04 04 01 04 01 00 02 02 03 01 01 01 01 01 01 01 02 02 01 02 02 02 02 02 02 02 04 00 01 15 14 14 14 14 14 15 01 04 04 04 04 04 04 04
04 04 04 04 01 00 04 00 01 04 01 00 00 00 00 01 00 02 02 02 02 02 02 02 02 02 02 02 02 02 02 02 04 04 01 15 14 14 14 14 14 15 01 01 00 04 04 04 04 04
04 04 04 04 01 04 04 03 01 04 01 04 00 00 00 01 00 02 02 02 02 02 02 02 05 05 05 05 03 03 00 00 00 00 01 01 14 14 14 14 14 01 01 01 00 04 04 04 04 04
04 04 04 04 01 04 04 04 01 04 01 04 04 01 01 01 00 02 02 02 02 02 02 03 05 05 03 03 05 05 00 04 00 00 04 01 01 01 01 01 01 01 01 01 00 00 00 04 04 04
04 04 04 04 01 04 04 04 01 04 01 04 00 00 00 01 00 04 02 02 02 02 02 02 02 03 00 00 00 00 00 00 00 00 04 01 01 01 01 04 04 01 00 00 00 00 04 04 04 04
04 04 00 03 01 04 04 04 01 04 01 04 04 04 00 01 00 01 04 01 01 01 01 01 01 01 01 01 01 01 01 01 01 01 17 01 01 01 04 01 01 01 00 04 04 04 04 04 04 04
04 04 04 04 01 04 04 00 01 04 01 04 04 04 00 01 00 04 04 00 00 01 00 00 01 00 00 01 00 00 01 00 00 00 04 04 04 04 04 04 04 01 04 04 04 04 04 04 04 04
04 03 04 04 01 01 01 01 01 01 01 04 04 04 00 01 00 04 00 00 00 01 00 00 01 00 00 01 00 00 01 04 04 04 04 00 00 01 01 01 01 01 01 01 04 04 04 04 04 04
04 04 04 04 01 04 04 04 01 04 01 04 04 01 04 01 00 04 01 01 01 01 00 00 01 00 00 01 00 00 04 04 04 04 04 00 00 01 04 04 04 01 04 01 04 04 04 04 04 04 
04 04 04 03 01 03 04 04 01 04 01 04 04 04 04 01 00 04 00 00 00 01 00 00 01 00 01 01 01 04 01 01 01 01 01 01 01 01 01 01 01 01 04 01 04 04 04 04 04 04
04 04 04 04 01 04 04 04 01 04 01 01 04 01 01 01 00 04 00 00 00 01 00 00 01 00 01 04 04 04 01 04 04 04 04 04 01 01 04 04 04 01 04 01 04 04 04 04 04 04
04 04 04 04 01 04 04 04 01 04 01 04 04 03 04 01 00 04 04 04 00 01 00 00 01 00 01 04 04 04 01 04 04 04 04 04 01 04 04 04 04 01 04 01 04 04 04 04 04 04
04 04 04 04 01 01 01 04 01 04 01 04 04 04 04 01 04 04 00 04 00 01 00 00 01 00 01 04 04 04 01 04 04 04 04 04 01 04 04 04 04 01 04 01 04 04 04 04 04 04
04 04 04 04 04 01 01 01 01 04 01 04 01 04 01 01 04 01 01 04 01 01 01 01 01 01 01 01 01 04 01 01 01 01 01 01 01 01 01 01 01 01 01 01 04 04 04 04 04 04
04 04 04 04 04 01 03 04 01 01 01 04 01 01 04 01 00 00 00 04 00 00 00 00 01 04 04 04 04 04 01 00 00 00 00 00 00 00 17 04 04 00 04 04 04 04 04 04 04 04
04 00 04 04 03 01 04 00 01 04 01 04 03 04 04 01 04 00 00 04 04 00 00 00 01 04 04 04 04 04 01 00 00 00 00 00 00 00 01 01 01 01 01 01 04 04 04 04 04 04
04 03 04 04 04 01 04 04 01 04 01 04 04 04 04 01 00 00 00 00 04 00 00 00 01 00 00 00 04 04 01 00 00 00 01 00 00 00 01 00 00 01 00 00 00 04 04 04 04 04
01 04 04 04 01 01 04 04 01 04 04 01 01 04 04 01 04 00 01 01 04 01 01 01 01 04 04 00 04 04 01 00 00 00 01 00 00 00 01 00 00 01 00 00 00 04 04 04 04 04
04 04 04 04 01 04 03 04 01 04 04 04 01 04 04 01 00 00 01 04 04 04 04 04 01 04 04 00 04 04 01 00 00 00 01 01 01 01 01 00 00 01 00 00 00 04 04 04 04 04
04 04 04 04 01 04 04 04 01 04 04 04 01 04 04 01 00 00 01 04 04 04 04 04 01 01 01 01 01 04 01 01 00 00 01 00 00 00 00 00 00 01 00 00 00 04 04 04 04 04
04 04 04 04 01 04 04 04 01 04 04 04 01 01 01 01 04 01 01 00 04 01 01 01 01 00 00 00 00 04 04 01 00 00 01 00 00 00 00 00 00 01 01 01 01 04 04 04 04 04
04 04 04 04 01 04 04 00 01 04 04 04 00 04 04 01 00 04 01 04 04 01 04 04 01 00 00 00 00 00 04 01 00 00 01 01 01 01 01 01 01 01 04 04 04 04 04 04 04 04
04 04 03 04 01 01 01 01 01 04 04 01 01 01 01 01 04 04 01 01 04 01 04 04 01 00 00 00 00 00 00 04 01 01 01 00 00 01 00 00 01 01 04 04 04 04 04 04 04 04
04 04 04 04 04 04 04 01 04 04 04 01 04 04 01 00 04 04 04 04 04 04 04 04 01 00 00 00 00 00 00 00 04 00 04 00 00 01 00 00 01 01 04 04 04 04 04 04 04 04
04 04 04 04 04 04 04 01 04 04 00 01 04 04 01 04 04 00 00 00 04 00 00 00 01 00 00 00 00 00 00 00 04 00 01 01 01 01 01 01 01 01 01 01 04 04 04 04 04 04
04 04 04 04 03 04 03 01 04 04 04 01 04 04 05 00 04 00 00 00 04 00 00 00 01 00 00 00 00 04 04 04 04 00 01 12 10 10 10 07 01 04 00 01 04 04 04 04 04 04
04 04 04 04 01 01 01 01 04 04 04 01 01 01 01 00 04 00 00 00 04 00 00 00 00 00 00 00 00 00 00 00 00 00 01 13 10 10 10 13 01 04 00 01 04 04 04 04 04 04
04 04 04 04 01 04 04 01 04 04 04 04 16 16 17 16 16 04 04 04 04 04 00 01 00 00 00 00 00 00 00 00 00 01 01 13 10 10 10 13 01 04 00 01 04 04 04 04 04 04
04 04 04 04 01 04 04 01 01 01 01 01 16 17 17 17 16 00 04 00 00 00 00 01 00 00 00 00 00 00 00 00 00 00 01 11 19 19 19 18 01 00 04 01 04 04 04 04 04 04
04 04 04 04 01 01 04 01 04 04 04 01 16 17 17 17 16 04 01 04 04 04 04 04 01 04 04 04 04 04 04 04 04 04 01 15 14 14 14 15 01 04 01 01 04 04 04 04 04 04 
04 04 04 04 04 01 04 01 16 04 04 01 16 17 17 17 16 00 01 04 04 04 04 04 04 04 01 04 04 04 01 04 04 04 01 15 14 14 14 15 01 01 01 04 04 04 04 04 04 04 
04 04 04 04 04 01 04 01 01 01 01 01 16 17 17 17 16 04 01 04 04 04 04 04 04 04 01 04 04 04 01 04 04 04 01 01 14 14 14 01 01 01 01 01 04 04 04 04 04 04 
04 04 04 04 04 01 04 04 04 04 04 01 16 17 17 17 16 04 01 01 01 01 01 01 01 01 01 04 04 04 01 04 04 04 01 01 04 04 04 01 04 04 04 01 04 04 04 04 04 04 
04 04 04 04 04 01 01 04 04 04 04 01 16 16 16 16 16 04 01 04 04 04 04 04 04 04 01 04 01 01 01 01 01 01 01 01 01 01 01 01 04 04 04 01 04 04 04 04 04 04 
04 04 04 04 04 04 01 01 01 01 01 01 01 01 01 01 01 17 01 04 04 04 04 04 04 04 01 04 01 04 04 04 04 04 04 04 04 04 04 04 04 04 04 01 04 04 04 04 04 04 
04 04 04 04 04 04 04 04 04 04 04 04 04 04 04 01 01 04 01 01 01 01 01 01 01 01 01 01 01 04 04 04 04 04 04 04 04 04 04 04 04 04 04 01 04 04 04 04 04 04 
04 04 04 04 04 04 04 04 04 04 04 04 04 04 04 04 04 04 04 04 04 04 04 04 04 04 04 04 04 04 04 04 04 04 04 04 04 04 04 04 04 04 04 01 04 04 04 04 04 04 
04 04 04 04 04 04 04 04 04 04 04 04 04 04 04 04 04 04 04 04 04 04 04 04 04 04 04 04 04 04 04 04 04 04 04 04 04 04 04 04 04 04 04 01 04 04 04 04 04 04 
04 04 04 04 04 04 04 04 04 04 04 04 04 04 04 04 04 04 04 04 04 04 04 04 04 04 04 04 04 04 04 04 04 04 04 04 04 04 04 04 04 04 04 01 04 04 04 04 04 04 
04 04 04 04 04 04 04 04 04 04 04 04 04 04 04 04 04 04 04 04 04 04 04 04 04 04 04 04 04 04 04 04 04 04 04 04 04 04 04 04 04 04 04 04 04 04 04 04 04 04 